0 xE** -> N 0
0 *x** -> E 3
0 NE** -> x 2
1 **Wx -> S 1
1 **X* -> W 2
1 **WS -> x 3
2 N*x* -> W 2
2 x*** -> N 0
2 N*W* -> x 1
3 *x*S -> E 3
3 ***x -> S 1
3 *E*S -> x 0

